NO ./textures/brick.xpm

SO ./textures/brick.xpm

WE ./textures/oldwood.xpm

EA ./textures/oldwood.xpm

F 102, 51, 0

C 179, 236, 255

1111111111111 111111111111
1000000000001 100000000001
1000110000001110000N000001
10000000011000001100000001
111111000000000000000000011111111
     1000000000000000000000000001
111111000111100000000000000000001
100000000000000000000000000000001
100011100011100000111000001110001
10001 10001 1000001 1000001 10001
11011 11011 1100011 1100011 11011
 111   111   11111   11111   111
